test
XXXXXXXXXXXXXXX
XBCXCCCX X    X
XCXXXXX  X    X
XXX      X    X
X     C  X    X
XTXX     X    X
XX X     X    X
XEXX     X    X
X        X    X
XXXXXXXXXXXXXXX
X             X
X             X
X             X
X             X
XXXXXXXXXXXXXXX
#switch:[1](1,3) (1,1)
#switch:[1](4,1) (4,2) (4,3)
#switch:[1](4,1) (4,2) (4,3) (4,4)
#switch:[1](4,3) (4,2) (4,1)
#switch:[1](3,1) (1,1)
#switch:[1](6,3)
#tp:(6,2)
