test
XXXXXXXXXX
XB       X
X        X
X        X
X       EX
X        X
X        X
X        X
X        X
XXXXXXXXXX
