Run
xxxxxxxxxxxxx
xBX   x   x E
x x x x x x x
x x x x x x x
x x x x x x x
x x x x x x x
x x x x x x x
x x x x x x x
x x x x x x x
x   x   x   x
xxxxxxxxxxxxx