Transunivers
XXXXXXXXXXXXXXX
XB     X      X
X      X      X
X  T   X      X
X      X      X
X      X      E
XXXXXXXXXXXXXXX
#tp:(8,3)
