Default
XXXXXXXXXX
XB       X
X        X
X        X
X        X
X        X
X        X
X        X
X       EX
XXXXXXXXXX
